
/home/althausc/master_thesis_impl/graph2vec
   .
   |-dataset
   |-features
   |-models
   |---02-08_20-01-39*-pbn
   |---02-17_11-36-44**-art500k
   |---12-16_11-47-55*-pbn
   |---logs
   |---trainconfigs
   |-----02-08_19-59-41
   |-----02-08_20-01-09
   |-----02-08_20-01-39*-pbn
   |-----02-08_22-43-23
   |-----02-08_22-44-25
   |-----02-08_22-44-49
   |-----02-11_12-36-28
   |-----02-11_12-37-17
   |-----02-11_12-37-25
   |-----02-17_06-06-01-from-here-TE
   |-----02-17_06-15-31
   |-----02-17_11-36-44**-art500k
   |-----12-09_12-27-06
   |-----12-09_12-58-59
   |-----12-09_13-22-38
   |-----12-09_13-29-32
   |-----12-09_15-22-58
   |-----12-09_15-23-05
   |-----12-09_15-23-27
   |-----12-09_15-45-57
   |-----12-09_17-10-23
   |-----12-09_17-11-34
   |-----12-09_17-16-13
   |-----12-10_10-13-40
   |-----12-10_10-31-58
   |-----12-10_11-57-01
   |-----12-10_13-02-51
   |-----12-10_13-03-24
   |-----12-10_15-24-26
   |-----12-10_15-24-44
   |-----12-10_15-38-54
   |-----12-10_15-54-00
   |-----12-10_18-44-52
   |-----12-10_18-45-17
   |-----12-11_11-11-00
   |-----12-11_11-11-43
   |-----12-11_12-22-53
   |-----12-11_12-23-26
   |-----12-11_16-20-52
   |-----12-11_16-22-34
   |-----12-11_17-10-51
   |-----12-11_17-26-08
   |-----12-11_17-26-51
   |-----12-12_10-34-58-kaggle-from-here-on
   |-----12-12_10-47-02
   |-----12-12_10-48-03
   |-----12-14_17-51-56
   |-----12-14_17-52-56
   |-----12-15_10-19-05
   |-----12-15_15-14-34
   |-----12-15_15-21-34
   |-----12-16_09-37-00
   |-----12-16_11-47-55*-pbn
   |-----12-17_17-03-33
   |-----12-17_17-04-02
   |-----12-18_10-47-20
   |-----12-18_10-47-30
   |-----12-19_19-09-36
   |-----12-19_19-10-04
   |-----12-19_19-10-34
   |-----12-21_19-32-35
   |-----12-21_19-34-22
   |-----12-21_19-34-39
   |-----12-23_10-12-26
   |-----12-23_10-13-35
   |-----12-23_10-13-36
   |-----12-23_10-17-38
   |-----12-23_10-17-39
   |-----12-23_10-19-24
   |-----12-23_11-56-53
   |-----12-23_19-33-15
   |-src
   |---__pycache__

